Hamg	HeroArchMage	AInv	AHbz,AHab,AHwe,AHmt
Hblm	HeroBloodMage	AInv,Asph	AHfs,AHbn,AHdr,AHpx
Hmkg	HeroMountainKing	AInv	AHtc,AHtb,AHbh,AHav
Hpal	HeroPaladin	AInv	AHhb,AHds,AHre,AHad
Obla	HeroBladeMaster	AInv	AOwk,AOcr,AOmi,AOww
Ofar	HeroFarSeer	AInv	AOfs,AOsf,AOcl,AOeq
Oshd	HeroShadowHunter	AInv	AOhw,AOhx,AOsw,AOvd
Otch	HeroTaurenChieftain	AInv	AOsh,AOae,AOre,AOws
Edem	HeroDemonHunter	AInv,Ault	AEmb,AEim,AEev,AEme
Edmm	HeroDemonHunterMorph	AInv,Ault	AEmb,AEim,AEev,AEme
Ekee	HeroKeeperoftheGrove	AInv,Ault	AEer,AEfn,AEah,AEtq
Emoo	HeroMoonPriestess	Ashm,AInv,Ault	AHfa,AEst,AEar,AEsf
Ewar	HeroWarden	Ashm,AInv,Ault	AEbl,AEfk,AEsh,AEsv
Ucrl	HeroCryptLord	AInv	AUim,AUts,AUcb,AUls
Udea	HeroDeathKnight	AInv	AUdc,AUdp,AUau,AUan
Udre	HeroDreadLord	AInv	AUav,AUsl,AUcs,AUin
Ulic	HeroLich	AInv	AUfn,AUfu,AUdr,AUdd
Nbrn	HeroBansheeRanger	AInv	ANsi,ANba,ANdr,ANch
Nbst	HeroBeastMaster	AInv	ANsg,ANsq,ANsw,ANst
Nngs	HeroNagaSeaWitch	AInv	ANfl,ANfa,ANms,ANto
Npbm	HeroPandarenBrewmaster	AInv	ANbf,ANdh,ANdb,ANef
Nplh	HeroPitLord	AInv	ANrf,ANht,ANca,ANdo
Ecen	cenarius	AInv,SCc1	AEer,AEfn,AEah,AEtq
Eevi	evil_illidan	AInv,Ault,ANcl	AEmb,AEim,AEev,AEvi
Eevm	evil_illidanmorphed	AInv,Ault,ANcl	AEmb,AEim,AEev,AEvi
Efur	furion	AInv,Ault	AEer,AEfn,AEah,AEtq
Eidm	illidan_demon_form	AInv,Ault	AEmb,AEim,AEev
Eill	illidan	AInv,Ault	AEmb,AEim,AEev,AEIl
Eilm	illidanmorphed	AInv,Ault	AEmb,AEim,AEev,AEIl
Ekgg	keeper_ghost	AInv,Ault	AEer,AEfn,AEah,AEtq
Emfr	Malfurion	AInv,Ault	AEer,AEfn,AEah,AEtq
Emns	Malfurion_no_stag	AInv,Ault	AEer,AEfn,AEah,AEtq
Etyr	Tyrande	AInv,Ashm,Ault	AHfa,AEst,AEar,AEsf
Ewrd	Maiev	Ashm,AInv,Ault	AEbl,AEfk,AEsh,AEsv
Hant	antonidus	AInv	AHbz,AHab,AHwe,AHmt
Harf	arthas_with_frostmourne	AInv	AHhb,AHds,AHre,AHad
Hart	arthas	AInv	AHhb,AHds,AHre,AHad
Hdgo	Dagren_the_Orcslayer	AInv	AHhb,AHds,AHre,AHad
Hhkl	Halahk_the_Lifebringer	AInv	AHhb,AHds,AHre,AHad
Hjai	jaina	AInv	AHbz,AHab,AHwe,AHmt
Hkal	Kael	AInv,Asph	AHfs,AHbn,AHdr,AHpx
Hlgr	Lord_Garithos	AInv	ANsh,AHhb,AHad,ANav
Hmbr	muradin_bronzebeard	AInv	AHtc,AHtb,AHbh,AHav
Hmgd	Magroth_the_Defender	AInv	AHhb,AHds,AHre,AHad
Hpb1	Paladin_Boss_1	AInv	AHhb,AHds,AHre,AHad
Hpb2	Paladin_Boss_2	AInv	AHhb,AHds,AHre,AHad
Huth	uther	AInv	AHhb,AHds,AHre,AHad
Hvsh	Lady_Vashj	AInv	ANfl,ANfa,ANms,ANto
Hvwd	sylvanus_windrunner	AInv,Ault	AHca,AEst,AEar,AEsf
Nbbc	blackrock_blademaster	AInv	AOwk,AOcr,AOmi,AOww
Nmag	Magtheridon	AInv	ANrf,AN_ht,ANca,ANdo
Nman	Mannoroth	AInv	AOsh,AHtc,AOeq,ANrn
Npld	Pit_Lord	AInv	AOsh,AHtc,AOeq,ANrn
Nsjs	Chen_Stormstout	AInv	ANcf,Acdh,Acdb,Acef,Aamk
Ocbh	cairne_bloodhoof	AInv	AOsh,AOae,AOre,AOws
Ocb2	cairne_bloodhoof_war3x	AInv	AOs2,AOr2,AOr3,AOw2,Aamk
Odrt	DrekThar	AInv	AOfs,AOsf,AOcl,AOeq
Ogrh	grom_hellscream	AInv	AOwk,AOcr,AOmi,AOww
Opgh	possessed_grom_hellscream	AInv	AOwk,AOcr,AOmi,AOww
Orex	Rexxar	AInv	Arsg,Arsq,ANsb,Arsp,Aamk
Orkn	Rokhan	AInv	ANhw,ANhx,Arsw,AOls,Aamk
Osam	Samuro	AInv	AOwk,AOcr,AOmi,AOww
Otcc	cairne_bloodhoof_cinematic	AInv	AOsh,AOae,AOre,AOws
Othr	thrall	AInv	AOfs,AOsf,AOcl,AOeq
Uanb	anubarak	AInv	AUim,AUts,AUcb,AUls
Ubal	balnazzar	AInv	AUsl,AUav,ANr3,AOeq,ACf3
Uclc	kelthuzadlich_cinematic	AInv	AUfn,AUfu,AUdr,AUdd
Udth	detheroc	AInv	AUsl,AEsh,AUcs,AUdd
Uear	evil_arthas	AInv	AUdc,AUdp,AUau,AUan
Uktl	kelthuzadlich	AInv	AUfn,AUfu,AUdr,AUdd
Umal	malganis	AInv	AUsl,AUcs,ANsl,ANdc
Usyl	Evil_Sylvanas	AInv	ANsi,ANba,ANdr,ANch
Utic	tichondrius	AInv	AUsl,AUcs,ANrc,ANfd
Uvar	varimathras	AInv	AUsl,AUav,ANrf,ANdo
Uvng	Vengyr	AInv	AUav,AUsl,AUcs,AUin
Uwar	archimonde	AInv,ACm2	ANrc,ANdp,ANfd,AHbh
Hgam	ghostly_archmage	AInv	AHbz,AHab,AHwe,AHmt
Naka	akama	AInv,Apiv,Ahid	ACs7,AOcl,AEsh,ANr2